    NO                          ./assets/textures/NO.xpm
             SO                                        ./assets/textures/SO.xpm
        WE                                  ./assets/textures/WE.xpm
  EA           ./assets/textures/EA.xpm

F                              255,25,50
              C                                                    255,25,50

        1111111111111111111111111
        1000000000110000000000001  
        1011000001110000000000001
        1001000000000000000000001
111111111011000001110000000000001
1000000000110000011101111101111111111
11110111111111011100000010001      1
11110111111111011101010010001      1
11000000110101011100000010001      1
1000000000N000001100000010001
10000000000000001101010010001          
11000001110101011111011110001      1
11110111 1110101 10111101000111111101      
11111111 1111111 111111111111      1