	NO                          ./img/512debug/nord.xpm
             SO                                        ./img/512debug/sud.xpm
        WE                                  ./img/512debug/west.xpm
  EA           ./img/512debug/est.xpm

F                              ./img/512debug/est.xpm
              C                                                    255,25,55

    	111111  111111111111111111
        100000  000110000000000001  
        101100  001110000000000001
        100100  000000000000000001
11111111101100  001110000000000001
10000000001100  0011101111101111111111
11110111111111  11100000010001      1
11110111111111  11101010010001      1
11000000110101  11100000010001      1
1000000000N000  01100000010001
10000000000000  01101010010001      	
11000001110101  11111011110001      1
11110111 11101  1 10111101000111111101      
11111111 11111  1 111111111111      1