NO ./assets/textures/NO.xpm
SO ./assets/textures/SO.xpm
WE ./assets/textures/WE.xpm
EA ./assets/textures/EA.xpm

F 131,131,131
C 70,70,70




111111 111111
100101 100101
101001 101001
110001 1100E1
111111 111111