NO ./assets/NO.xpm
SO ./assets/SO.xpm
WE ./assets/WE.xpm
EA ./assets/EA.xpm

F 164,59,249
C 255,25,50




111111 111111
100101 100101
101001 101001
110001 1100E1
111111 111111