C 70,70,70

F                    131,131,131
                NO                            ./assets/textures/NO.xpm
                             SO                                      ./assets/textures/SO.xpm
WE                                       ./assets/textures/WE.xpm
                            EA                                      ./assets/textures/EA.xpm

111111
100001
10W00110000011111
10000111111111111
111111
