C 70,130,180

F 34,139,34
NO ./game_assets/NO.xpm
SO ./game_assets/SO.xpm
WE ./game_assets/WE.xpm
EA ./game_assets/EA.xpm

1111111111111111111111111
1000000000110000000000001
1011000001110000010000001
1001000000000000001000001
1111111101100000111000001
1000000000110000011100001
1011000001110000010000001
1001000000000000001000N01
1111111110110000011100001
1000000000110000011100001
1011000001110000010000001
1001000000000000001000001
1111111111111111111111111
